0, 0, 1, 1, 1, 1, 0, 0
1, 1, 1, 0, 2, 1, 1, 1
1, 3, 0, 2, 0, 5, 0, 1
1, 0, 3, 4, 6, 0, 5, 1
1, 1, 1, 6, 0, 1, 1, 1
0, 0, 1, 1, 1, 1, 0, 0

0, 0, 1, 1, 1, 1, 0, 0
1, 1, 1, 2, 2, 1, 1, 1
1, 3, 0, 0, 0, 0, 5, 1
1, 3, 0, 0, 0, 0, 5, 1
1, 1, 1, 6, 6, 1, 1, 1
0, 0, 1, 1, 1, 1, 0, 0

